25
25
2
1111111111111111111111111
1200002002222020222020001
1210101012101212101012101
1220000220002000222000001
1210121012101012101210101
1222220000020000200200221
1010121012101210101010101
1202000020022220202000001
1010101010101010121010101
1000002020200000020202221
1012101012121010101010121
1022020000200000200000021
1212121010101012101012101
1002000020202200200000001
1010121210101010101012121
1222000002202000002222221
1010101012101210121210121
1200220000000200202020001
1010101012121012121010101
1002200002220000000002021
1010101010101010121012101
1222202022220200002002001
1210101210121010101012101
1020002000022022022002001
1111111111111111111111111
