25
10
2
1111111111111111111111111
1200000200022202020200221
1012121010101012121010101
1022200200220202002002001
1210101212101010121012101
1222002002000002202000001
1010121010101210101012101
1022020200020200202002001
1012101012121012121012101
1111111111111111111111111
