22
28
8
1111111111111111111111
1000000001111111111111
1012121200211111111111
1021212100022222222221
1012121201000000000001
1021212101000000000001
1012121201011000000001
1021212100022200001111
1000000001211111000111
1000222000000000000001
1001222000000000000001
1000000000000000000001
1000000000000000000001
1000000000000000000001
1000000000000000000001
1000000000000000000001
1000000000000000000001
1000000000000000000001
1000000000000000000001
1000000000000000000001
1000000000000000000001
1000000000000000000001
1000000000000000000001
1000000000000000000001
1000000000000000000001
1000000000000000000001
1000000000000000000001
1111111111111111111111