100
100
15
1111111111111111111111111111111111111111111111111111111111111111111111111111111111111111111111111111
1020022202222200202020200000202002000002220020200000000220002200022002200222020022200020022000200221
1210121210101210121212101210101210101012101010101212101012121212121012101010121010121210121012101211
1022000020000000022022220222000220200222020000002200200200000222000022202200202000200020220022020021
1012101210101012101210101010101210121010101010121010101212101212101012101012121010101210101012101011
1000200220222202020002020022020000022220020222200200220020002222000002222202000202200020000202220221
1010101010101010101010121012121210101210121210101212101010121210121012101012121010121010121212101011
1020002200200220200020020200020220000020202200220020200222000020202200002022200002020002222000002201
1012101210101012121010121210101210101010101210121210121012101010101210101212121010121010101010101011
1020220002000220000002022200200002220222002000002000022002000222200020000020202020000222002202022001
1212121012121012121212101010101212101012121012101010121010121212101012101010101010121010101210101011
1022200202002202002202002220000222000200022222222200200022200200222000002000022000200000022020020021
1010101012121010101212101010101210101012121010121010101010121212121012101212121010121012101012101011
1220002000000020022020000020200022002200000200200022200202222202200002222002220202020020202202020201
1210121210101010121012121010101012121012121010101210101010121210101210121210101212101010101212101211
1200022220000002002000220000000202200000220000020222020222000020202000000202202200022000202200002201
1010121212121210121010121010101212101010101010121210101210101010101210101212121012101010121210121011
1000000000222002202020022020020202020020220222002222000220020220022000002000002020000000020222200001
1210121010101012101010121212121210101212121010101212101210101012121010121010101012101012101210121211
1020022200202020000222020202200020200020222002000220000002200022000022200000222020022200222000002021
1210101010101010121012101212101212101012121010101010121212121012101012121210121210101010121210101011
1202202200002020222020200000220200000002020200022220200002000202202020200020022222020220002022002001
1012101010101012101212101210121210101210121012121210101012101010101212121012101212121010101012101011
1200220000002000002020020020022202022000000022020000002020002220200200200022022002022002020222200221
1012101012101210121012101210101210101012101212121010121010101210121212101212101210121210101012101011
1000020022220020000202022022002020000202020000222200022200000200000000002020202002002002000222000221
1010101210121210101012101012101010101012101010101012121210121212101010101210101010121010101212121211
1200000200020002002020020200202000020002220000000000022020000000020002200222220022020200020002202221
1010101012101210101012101010101010101212101010101012101210101212121012101010121012121010121010101011
1202020002222200022000222220002020020202002000022202200200220202002000002000000002000222022000000221
1010101010121210101012121012101210101010121012121010101212101210101010121212101010101010121212121011
1020200222202000220002002000200222000002200020202020220022020200200020022002200020000000022002200021
1212121012101010121210101012101010121012101010101210101210101010101010121010101012121010101210121011
1000220002200200000200020220020000000220200002202222002200202000020022020200002200202000022000000001
1010121010101210121012121010121012101010101012101012121012121210121012121210101012101212101210121211
1200002220200220222202022220000000002002000020022202022000022022000002002202222000020200002220222001
1212121212101012101210121012121210121010121010121012101210101212101010121012101212101212121010101211
1220000000202000220022020002002220022022202020020002222000020220022200202002220220000220200202000001
1012101010121210121010101010121010101012121012121010101012101010121010121212101010101010121012101011
1020020002020020200022200202202000200020002020200000000002200000000020000020000002000220000020000201
1212121010101012121012101012121010101010101010101010101010121012101010101212101012101010101212121211
1002020000000202020020000200020020002220002200002000000000200000002000000220200022000220220000200021
1012101212121012101010101010121210121210101210101210121012101010121010101210101012121212121210121011
1000200220002022020000020200220202000200022000200000000200200022000002202000200020002002002200200021
1210101210101012101210101210121210101012101012101012101010101012121010101012121012101010101012101011
1000220220020200220200220000002022202200200000222000000202000200222200020200222202022200200200002201
1010121010101010101212101210101010101210101012121210101012121010101210101012101210101010101012101211
1020200220222022000000022020002020200220200020022000000022200022000202222202222220020002222220200221
1010101210121010121212101212101210101212101010101010121210101212121212101012101210121210121010121011
1022202200202002200022202002200200200022002020000000222202020020200002222220002200200000000022000001
1012101012121010101010121210101210101012101012101212101012121010101212101012101010121012121212101011
1200202222202002222220202000020222022002220020000200222020200202220020200200002222220220200200000201
1212101010101010121212101012101210101210121212101210101010101210101012121212121210121012101210101211
1000202002020220022220222202022000222002200000000200200002200220022202002200000000220022220020000021
1010101010101210101012121212101210101210121210101012121010101010101012101010101212121010101012101011
1020222022020002202020000200000222202000022000200202000200000022200200200220000000020220020022220201
1012121010121010101212121210101210101010101210101210101010121210121210121012121210101212121010121011
1020000000200202000002000020200020000020000022000020000000200022220000000020000200220020020200200201
1210101210121210101010101210101010121212101012121212101210101212101010121010101210101010101012121211
1202022020020002220022022220220202020000022200000220020222220000020202000022020022222220000020200001
1010121010121012101010121212101210101010121010101012101010121010101210101210121010101010101212101011
1220022222022202002202020220202000000202200022222200022022020020220220002220020000000000022220200201
1010101010101212121212101212121010101012101212121210101010101210101010101010121210121010101010121211
1020002000200020200222020220022202200200202200020000222022000000000002000002002002002022000220200021
1012101210101212101210121010101210121010101210121212121012121010121012101010101210101010101012121211
1222002000200222000020000002020000222202220022002222002202020222222202200000202200202020202000002221
1210121012121012101012101012101212121012101010121210101010121212101210121012101012101210101012121011
1022000000200000202000002202022200000222000022000000000000020200222002020200022220200022202000000001
1212121012101210121010101012121010101012101012101010101010121012101212101010101012121012121210121011
1200022000002000000022000002000202202202020022020000000200200000002220000020020202022002020222002001
1212101210121210121010121210121010101012121010101010121210101012101012121010101010121210101010101211
1000022000222000020202202000202000200000000000000020022000020020002000022000020220202002020000022201
1012101012121012101012121210101210121010121212121012101212121010101012121010101012121212101210101211
1200000200202220002000220002022200202200000200200002000000202202000020000202000200000002000000200021
1010101012121210101210121010121012101012121012101010101012101010101010121210101012101210121210121011
1000002000220000022000200000002000000220002202220000222202220220002000000222222200022222022222202201
1010121010101210121210101010101012101212121010121210101012101212121210101012101210101210101010101011
1200000002000022002200002020002002200200200020002202000022022220020002202002002200222200020222020221
1012121010101012101210101012121012101012101212101012101012101210101010101012121012101012101010121011
1200002020002002022222202022002020200002202000002020022220222002002000002222002002000222022202002221
1010121212101010121210101212101212101012101010101210101212101010121010121210101012101212121010101011
1220000020020220220220220022020000020002202020222002002200222202002020002020220220020022000000000201
1210121010101010121010101012101010121210101212121212101010121210101010121010101212121210121010101011
1000020200002200202022022000200020022020000200202002000022022000022200002000200222000222202000020021
1210101012121010121212121012101010101010121010121212101210101212121010121012121010101210101210101211
1000020020002002220000002222220000222220002002020200200000000200202022200020022020200222020022000021
1012101012121012101210101010101012101210121212101010101012121012101010101012121012101212121212101011
1000002020200022200022200222200020200202202000202000000200202200200202020002202022000002000200220001
1012121210121210101212121010101012101012101012121210121010121010101212101210121010101210101212101011
1022000000022000200220020002022000002220200222020020000020020000000000020002020000022000000220202001
1212101012101210101012101212121012121012101010101010101010101012121010101212121212101010101210121011
1020002220020202000222200020220222000202002000000000202200020020220220200000000000200020020000020021
1010121012101010101210101010101212101010121012101010101212101010121010121012121010121010101210121011
1022220202200200020022022002002200002022002020220220200222220000022022022002002020002200000002220021
1012121010101010101010121010101010121012101012101010121210121010101010101012121212101010121212101011
1000000022022202200020202002200000220000002022002002202000020000000220020000200202200020220202000021
1210101012101010101212101210121010101210101210101210101210121210101010121212101212101010121210121211
1200220022000220000020000000000202020000002022002200002000200020200202000002200002202000002002202201
1212101012101212101010121010101210121010101012101010121210121210101212101210101012101210121010121211
1111111111111111111111111111111111111111111111111111111111111111111111111111111111111111111111111111
